"filename", "language", "Java", "comment", "blank", "total"
"/Users/saugatsingh/Documents/Projects/Softwarica/class/src/main/java/com/example/demo/config/PasswordEncoderConfig.java", "Java", -2, 0, 0, -2
"/Users/saugatsingh/Documents/Projects/Softwarica/class/src/main/java/com/example/demo/config/RestExceptionHandler.java", "Java", -1, 0, 0, -1
"/Users/saugatsingh/Documents/Projects/Softwarica/class/src/main/java/com/example/demo/controller/ApiController.java", "Java", -5, 0, -3, -8
"/Users/saugatsingh/Documents/Projects/Softwarica/class/src/main/java/com/example/demo/controller/CommentController.java", "Java", -1, 0, 0, -1
"/Users/saugatsingh/Documents/Projects/Softwarica/class/src/main/java/com/example/demo/controller/FollowController.java", "Java", -8, 0, -2, -10
"/Users/saugatsingh/Documents/Projects/Softwarica/class/src/main/java/com/example/demo/controller/LikeController.java", "Java", 12, 0, 4, 16
"/Users/saugatsingh/Documents/Projects/Softwarica/class/src/main/java/com/example/demo/controller/PostController.java", "Java", 2, 0, -1, 1
"/Users/saugatsingh/Documents/Projects/Softwarica/class/src/main/java/com/example/demo/controller/UserController.java", "Java", -5, 0, 0, -5
"/Users/saugatsingh/Documents/Projects/Softwarica/class/src/main/java/com/example/demo/dto/postDto/PostResponseDto.java", "Java", 1, 0, 0, 1
"/Users/saugatsingh/Documents/Projects/Softwarica/class/src/main/java/com/example/demo/dto/profile/ProfileResponseDto.java", "Java", 2, 0, 0, 2
"/Users/saugatsingh/Documents/Projects/Softwarica/class/src/main/java/com/example/demo/entities/Comment.java", "Java", -1, 0, 1, 0
"/Users/saugatsingh/Documents/Projects/Softwarica/class/src/main/java/com/example/demo/entities/Follow.java", "Java", -2, 0, -1, -3
"/Users/saugatsingh/Documents/Projects/Softwarica/class/src/main/java/com/example/demo/entities/Like.java", "Java", 3, 0, 1, 4
"/Users/saugatsingh/Documents/Projects/Softwarica/class/src/main/java/com/example/demo/entities/Post.java", "Java", 2, 0, 0, 2
"/Users/saugatsingh/Documents/Projects/Softwarica/class/src/main/java/com/example/demo/entities/User.java", "Java", 7, 0, 1, 8
"/Users/saugatsingh/Documents/Projects/Softwarica/class/src/main/java/com/example/demo/mappers/PostMapper.java", "Java", 1, 0, 0, 1
"/Users/saugatsingh/Documents/Projects/Softwarica/class/src/main/java/com/example/demo/mappers/UserMapper.java", "Java", 2, 0, 0, 2
"/Users/saugatsingh/Documents/Projects/Softwarica/class/src/main/java/com/example/demo/repository/FollowRepository.java", "Java", -9, 0, -6, -15
"/Users/saugatsingh/Documents/Projects/Softwarica/class/src/main/java/com/example/demo/repository/FollowRespository.java", "Java", 10, 0, 7, 17
"/Users/saugatsingh/Documents/Projects/Softwarica/class/src/main/java/com/example/demo/repository/UserRepository.java", "Java", -2, 0, -2, -4
"/Users/saugatsingh/Documents/Projects/Softwarica/class/src/main/java/com/example/demo/security/SecurityConfig.java", "Java", -18, 16, -5, -7
"/Users/saugatsingh/Documents/Projects/Softwarica/class/src/main/java/com/example/demo/service/CommentService.java", "Java", 1, 0, 0, 1
"/Users/saugatsingh/Documents/Projects/Softwarica/class/src/main/java/com/example/demo/service/FollowService.java", "Java", -4, 0, 2, -2
"/Users/saugatsingh/Documents/Projects/Softwarica/class/src/main/java/com/example/demo/service/UserService.java", "Java", 0, 0, -1, -1
"/Users/saugatsingh/Documents/Projects/Softwarica/class/src/main/java/com/example/demo/service/serviceImpl/CommentServiceImpl.java", "Java", 6, 0, 1, 7
"/Users/saugatsingh/Documents/Projects/Softwarica/class/src/main/java/com/example/demo/service/serviceImpl/FollowServiceImpl.java", "Java", -25, -1, -4, -30
"/Users/saugatsingh/Documents/Projects/Softwarica/class/src/main/java/com/example/demo/service/serviceImpl/LikeServiceImpl.java", "Java", 2, 0, 1, 3
"/Users/saugatsingh/Documents/Projects/Softwarica/class/src/main/java/com/example/demo/service/serviceImpl/PostServiceImpl.java", "Java", 3, 2, -1, 4
"/Users/saugatsingh/Documents/Projects/Softwarica/class/src/main/java/com/example/demo/service/serviceImpl/UserServiceImpl.java", "Java", 5, 0, -1, 4
"/Users/saugatsingh/Documents/Projects/Softwarica/class/src/main/java/com/example/demo/utils/DateTimeUtil/DateTimeUtil.java", "Java", 42, 0, 10, 52
"Total", "-", 18, 17, 1, 36