"filename", "language", "Java", "comment", "blank", "total"
"/Users/saugatsingh/Documents/Projects/Softwarica/class/src/main/java/com/example/demo/ClassApplication.java", "Java", 0, -1, 0, -1
"/Users/saugatsingh/Documents/Projects/Softwarica/class/src/main/java/com/example/demo/controller/CommentController.java", "Java", 21, 0, 7, 28
"/Users/saugatsingh/Documents/Projects/Softwarica/class/src/main/java/com/example/demo/controller/LikeController.java", "Java", 21, 0, 7, 28
"/Users/saugatsingh/Documents/Projects/Softwarica/class/src/main/java/com/example/demo/controller/MainController.java", "Java", -12, 0, -6, -18
"/Users/saugatsingh/Documents/Projects/Softwarica/class/src/main/java/com/example/demo/controller/PostController.java", "Java", 6, 0, 2, 8
"/Users/saugatsingh/Documents/Projects/Softwarica/class/src/main/java/com/example/demo/controller/UserController.java", "Java", 31, 0, 8, 39
"/Users/saugatsingh/Documents/Projects/Softwarica/class/src/main/java/com/example/demo/dto/commentDto/CommentRequestDto.java", "Java", 15, 0, 3, 18
"/Users/saugatsingh/Documents/Projects/Softwarica/class/src/main/java/com/example/demo/dto/commentDto/CommentResponseDto.java", "Java", -6, 0, -1, -7
"/Users/saugatsingh/Documents/Projects/Softwarica/class/src/main/java/com/example/demo/dto/likeDto/LikeRequestDto.java", "Java", 21, 0, 6, 27
"/Users/saugatsingh/Documents/Projects/Softwarica/class/src/main/java/com/example/demo/dto/likeDto/LikeResponseDto.java", "Java", 11, 0, 6, 17
"/Users/saugatsingh/Documents/Projects/Softwarica/class/src/main/java/com/example/demo/dto/profile/ProfileRequestDto.java", "Java", 20, 0, 4, 24
"/Users/saugatsingh/Documents/Projects/Softwarica/class/src/main/java/com/example/demo/dto/profile/ProfileResponseDto.java", "Java", 18, 0, 4, 22
"/Users/saugatsingh/Documents/Projects/Softwarica/class/src/main/java/com/example/demo/mappers/CommentMapper.java", "Java", 10, 0, 6, 16
"/Users/saugatsingh/Documents/Projects/Softwarica/class/src/main/java/com/example/demo/mappers/LikeMapper.java", "Java", 10, 0, 6, 16
"/Users/saugatsingh/Documents/Projects/Softwarica/class/src/main/java/com/example/demo/mappers/UserMapper.java", "Java", 5, 0, 3, 8
"/Users/saugatsingh/Documents/Projects/Softwarica/class/src/main/java/com/example/demo/repository/PostRepository.java", "Java", 3, 0, 1, 4
"/Users/saugatsingh/Documents/Projects/Softwarica/class/src/main/java/com/example/demo/security/JwtAuthenticationFilter.java", "Java", -1, 0, 0, -1
"/Users/saugatsingh/Documents/Projects/Softwarica/class/src/main/java/com/example/demo/service/CommentService.java", "Java", 2, 0, 0, 2
"/Users/saugatsingh/Documents/Projects/Softwarica/class/src/main/java/com/example/demo/service/LikeService.java", "Java", 1, 0, 0, 1
"/Users/saugatsingh/Documents/Projects/Softwarica/class/src/main/java/com/example/demo/service/PostService.java", "Java", 1, 0, 0, 1
"/Users/saugatsingh/Documents/Projects/Softwarica/class/src/main/java/com/example/demo/service/UserService.java", "Java", 1, 0, -1, 0
"/Users/saugatsingh/Documents/Projects/Softwarica/class/src/main/java/com/example/demo/service/serviceImpl/CommentServiceImpl.java", "Java", 11, 0, 1, 12
"/Users/saugatsingh/Documents/Projects/Softwarica/class/src/main/java/com/example/demo/service/serviceImpl/LikeServiceImpl.java", "Java", 13, 0, 0, 13
"/Users/saugatsingh/Documents/Projects/Softwarica/class/src/main/java/com/example/demo/service/serviceImpl/PostServiceImpl.java", "Java", 8, 0, 1, 9
"/Users/saugatsingh/Documents/Projects/Softwarica/class/src/main/java/com/example/demo/service/serviceImpl/UserServiceImpl.java", "Java", 34, 0, 2, 36
"Total", "-", 244, -1, 59, 302